1111111111
10000000P1
10000CC011
1000000001
1000000011
11111C1111
1E000000C1
1111111111