1111111
10000P1
10000C1
1011111
10EC011
1111111