1111111
1100001
1E10PC1
1111111