1111111111111
0111111111110
11EPC11111111
1111111111111