111111111100111
100000000000001
11EPC1111111111
111111111100111