11111111111111
10000EPC111111
100E1E11111111
11111111111111
