111111111111
100070C00001
10000000P001
1000E0000001
111111111111