1111111
1E00001
1P00001
1111111