11111111111
1E00000C001
1000CCCCC01
1000CCCCC01
1000CCCCC01
1000CCCCC01
1000CCCCC01
1000CCCCC01
1000CCCCC01
1000CCCCC01
1000CCCCC01
1000CCCCC01
1000CCCCC01
1000CCCCC01
1000CCCCC01
1000CCCCC01
1000CCCCC01
1000CCCCC01
1000CCCCC01
1000CCCCC01
1000CCCCC01
1000CCCCC01
11111111111