111111
1PPPP1
1PPCP1
10EC01
111111